---------------
---------------
---------------
---------------
---------------
x--------------
-x-------------
--x------------
-E------------x
<>-x---------xx
[]--x-------xx-
[]---x-----xx--
[]----xxxxxx---
XXXXXXXXXXXXXXX