---------------
---------------
---------------
---------------
--E------------
S--------------
---------------
---------------
---------------
S--------------
---------------
---------------
xxxxxxxxxxxxxxx
XXXXXXXXXXXXXXX