---------------
---------------
SSSSSSSSSSSSSSS
SSSSSSSSS------
SSSSSSSSS------
SSSSSSSSS--QQ--
---------------
--------xxx-xxx
xxxxxxxxx--xx--
SSSSSSSSS--QQ--
SSSSSSSSS------
SSSSSSSSS------
SSSSSSSSS------
XXXXXXXXXXXXXXX