---------------
---------------
---------------
---------------
--------xxxxxxx
-------xx--QQQ?
------xx-------
-----xx------E-
---xxx-----SSSS
--xx<>---------
-xx-[]-------X-
xx--[]-------X-
x---[]----E--X-
XXXXXXXXXXXXXXX