---------------
---------------
---------------
---------------
-----xxxxxxxxxx
-----xx--QQQ?QQ
----xx---------
---xx------E---
--xx-----SSSSSS
--x------------
-xx--------X---
xx---------X---
x-------E--X---
XXXXXXXXXXXXXXX