---------------
---------------
-[]SSSSSSSSSSSS
-[]SSSSSSSSSSSS
-[]SSSSSSSSSSSS
-[]SSSSSSSSSSSS
-[]SSSSSSSSSSSS
-[]SSSSSSSSSSSS
--]SSSSSSSSSSSS
x-]SSSSSSSSSSSS
SSSSSSSSSSSSSSS
SSSSSSSSSSSSSSS
SSSSSSSSSSSSSSS
XXXXXXXXXXXXXXX