---------------
---------------
---------------
---------------
---------------
---------------
---------------
---------------
---------------
---------------
xx-------------
>-x------------
]--xxxxxxxxxxxx
XXXXXXXXXXXXXXX