---------------
---------------
SSSSSSSSSSSSSSS
SSSSSSSSSSS----
SSSSSSSSSSS----
SSSSSSSSSSS--QQ
---------------
----------xxx-x
xxxxxxxxxxx--xx
SSSSSSSSSSS--QQ
SSSSSSSSSSS----
SSSSSSSSSSS----
SSSSSSSSSSS----
XXXXXXXXXXXXXXX