x--------------
-xxxxxxxxxxxxxx
-QSSSSSSSSSSSSS
---------------
---------------
---------------
---------------
---------------
--------------E
----------E--<>
---E-----<>--[]
--<>-----[]--[]
--[]---E-[]--[]
XXXXXXXXXXXXXXX