---------------
---------------
SSSSSSSSSSSSSSS
SSSSSSSSSSSS---
SSSSSSSSSSSS---
SSSSSSSSSSSS--Q
---------------
-----------xxx-
xxxxxxxxxxxx--x
SSSSSSSSSSSS--Q
SSSSSSSSSSSS---
SSSSSSSSSSSS---
SSSSSSSSSSSS---
XXXXXXXXXXXXXXX