---------------
-----xxxxxxxxxx
-----xXXXXXXXXX
----xxXXXXXXXXX
---xx-XXXXXXXXX
---xS-XXXXXXXXX
---x--XXXXXXXXX
--xx--XXXXXXXXX
-xxS--XXXXXXXXX
xx----XXXXXXXXX
x-----XXXXXXXXX
X---E-XXXXXXXXX
------XXXXXXXXX
XXXXXXXXXXXXXXX