---------------
---------------
SSSSSSSSSSSS---
SSS------------
SSS-----------X
SSS--QQ------xx
------------xx-
--xxx-xxx--xx--
xxx--xx--xxx---
SSS--QQ--QQQ---
SSS------------
SSS------------
SSS------------
XXXXXXXXXXXX---