---------------
---------------
---------------
---------------
---------------
--------------S
---------------
---------------
---------------
---xxx-----S---
--xxX-x--------
Exx-X--x-------
xx--X---xxxxxxx
XX--XXXXXXXXXXX