---------------
---------------
SSSSSSSSSSSSSSS
SSSSSSSSSSSS---
SSSSSSSSSSSS---
SSSSSSSSSSSS---
---------------
---------------
------xxxxxxx--
x--xxxx-<><>-x-
-xxxXXX-[][]--x
EEEXXXX-[][]---
--XXXXX-[][]---
XXXXXXX-XXXXXXE