---------------
---------------
---------------
---------------
---------------
----------E-E-E
---------<><><>
---------[][][]
-----Q?--QQQQQQ
---------------
---------------
------xxx------
xxxxxxx--xxxxxx
XXXXXXX--XXXXXX