---------------
---------------
---------------
---------------
-----xxx-------
-----xx-x------
----xx---x----x
---xx-----x--xx
--xx-------xxxX
--x---------xXX
-xx-------EXXXX
xx--------XXXXX
x--------XXXXXX
XXXXXXXXXXXXXXX