---------------
---------------
---------------
-----------xxxx
----------xx---
---E------xX---
--<>-----xx----
--[]----xx-----
--QQQ-xxx------
-----xx<>------
----xx-[]------
---xx--[]------
xxxx---[]------
XXXX--XXXXXXXXX