---------------
---------------
---------------
---------------
-----xxxxx-----
----xxXXX-x----
---xx-XXX--x---
--xx--XXX---x--
-xxXX-XXX----x-
xxXXX-XXX-----x
xXXXX-XXX------
XXXXX-XXX------
XXXXX-XXX------
XXXX--XXXXXXXXX