---------------
---------------
---------------
---------------
---xxxxxxxxxxx-
---x--QQQ?QQQ-x
--xx-----------
-xx-----E------
xx----SSSSSSS--
x--------------
--------X------
--------X------
-----E--X------
XXXXXXXXXXXXXXX