---------------
---------------
---------------
---------------
-----------xxxx
----------xx---
---------xx----
--------xx-----
x--xxxxxx------
-xxx---<>------
--<>---[]------
--[]---[]-----X
E-[]---[]----XX
XXXXXXXXXXXXXXX