---------------
xxxxxxxxxxxxxxx
SSSSSSSSSSSSSSS
SSS------------
SSS------------
SSS------------
---------------
---------------
-E-------------
<>----------E--
[]--<>-----<>--
[]--[]-----[]--
[]--[]-----[]-E
XXXXXX---XXXXXX