---------------
---------------
---------------
---------------
---------------
---------------
---------------
---------------
---------------
xx-------------
S-x------------
S--x-----------
S---xxxxxxxxxxx
XXXXXXXXXXXXXXX