---------------
---------------
---------------
---------------
----xx--xxxx--x
---xx-xxx---xxx
--xx---<>----<>
-xx----[]----[]
xx-----[]----[]
x------XX----XX
S--------------
S--------------
S--------------
XXXXXXXXXXXXXXX