---------------
---------------
--------------S
---------------
xxxx-----------
x---x----------
-----x---------
------x--------
-------x-------
--------x------
---------x-----
----------x----
--E------X-xxxx
XXXXXXXXXXXXXXX