---------------
---------------
---------------
xxxxx----------
>----x---------
]S----x--------
>------x-------
]-------x------
Q?-------x-----
----E-----x----
---<>------x---
---[]-------xx-
---[]-------X-x
XXXXXXXXXXXXXXX