---------------
xxxxxxxxxxxxxxx
SSSSSSSSSSSSSSS
SSSS-----------
SSSS-----------
SSSS----E------
-------<>------
-------[]------
E-E----[]------
><>---?SSS--E--
][]--------<>--
][]--------[]--
][]--------[]--
XXXXXX----XXX--