--xxxx---------
-xx---x-------x
xx-----x-----xx
x-------x---xx-
E--------x-xx--
>---------xx---
]---------XX---
]--------------
]--------------
]--------------
]--------------
]--------------
]--------------
X-XXXXX--------