--xxx----------
-xx--x-------xx
xx----x-----xx-
x------x---xx--
E-------x-xx---
>--------xx----
]--------XX----
]--------------
]--------------
]--------------
]--------------
]--------------
]--------------
X-XXX----------