---xxx-----xxx-
--xx--xx--xx--x
--x----x-xx----
-xx-----xx-----
xx-------------
x--------------
x--------------
---------------
---------E-----
--------<>-----
--------[]-----
--------[]-----
--------[]-----
XXXXXXXX[]XXXX-