---------------
---------------
---------------
---------------
----xxxx-------
---xxXX-x------
--xxXXX--x-----
-xxXXXX---x----
xxXXXXX----x---
xXXXXXX-----x--
XXXXXXX------x-
XXXXXXX-------x
XXXXXXX-------X
XXXXXXXXXXXXXXX