---------------
---------------
---------------
---------------
---xxxxx-------
--xxXXX-x------
-xx-XXX--x-----
xx--XXX---x----
xXX-XXX----x---
XXX-XXX-----x--
XXX-XXX------x-
XXX-XXX-------x
XXX-XXX-------X
XX--XXXXXXXXXXX