---------------
---------------
---------------
---------------
---------------
---------------
x--------------
-x-------------
E-x---------xxx
>--x--------xx<
]---x------xx-[
]----x----xx--[
]-----xxxxx---[
XXXXXXXXXXXXXXX