---------------
---------------
---------------
---------------
----xxx--------
---xx--x-------
--xxX---x------
-xxXX----x-----
xxXXX-----x----
xXXXX---S--x---
XXXXX-------x--
XXXXX--------x-
XXXXX-------X-x
XXXX----XXXXXXX