---------------
---------------
---------------
---------------
---xx----------
--xx-x---------
-xx---x--------
xx-----x-------
x-------x------
---------x-----
----------x----
-----------x---
E---------X-xxx
XXXXXXXXXXXXXXX