---------------
---------------
---------------
---------------
---------------
E-----E-E-E----
>----<><><>----
]----[][][]----
Q?---QQQQQQ----
---------------
---------------
-xxxx---------x
xx---xxxxxxxxxx
XX---XXXXXXXXXX