---------------
xxxxxxxx-------
SSSSSSSS-------
---------------
---------------
E--------------
]--------------
]--------------
]--------------
]--------------
]-----SS-------
]-----SS-------
]-----SSxxxxxxx
XXX---XXXXXXXXX