---------------
---------------
SSSSSSSSSSS----
S--------------
S------------XX
S---QQ------xxx
-----------xx--
xxx--xxx--xx---
x--xxx--xxx----
S--QQQ--QQQ----
---------------
S--------------
---------------
XXXXXXXXXXX----