---------------
---------------
---------------
---------------
---xxxxxxxxxxx-
--xx--QQQ?QQQ-x
-xx------------
xx------E------
x-----SSSS-SS--
---------------
--------X------
--------X------
-----E--X------
XXXXXXXXXXXXXXX