---------------
---------------
---------------
------xxx------
---xxxx--x-----
--xx--X---x----
-xx--------x---
xx----------x--
-E-----------x-
<>------------x
[]-------------
[]-------------
[]-------------
XXXXXXXX-------