---------------
---------------
SSSSSSSSSSSSSSS
---SSSSS-------
---SSSSS-------
-E-SSSSS-------
->-------------
x]x------------
-]-xxxxxx------
-Q?SSSSS-x-----
----------x----
-----------x---
------------xxx
XXXXXXXXXXEXXXX