---------------
---------------
---------------
---------------
---------xxxxxx
--------xx--QQQ
-------xx------
------xx------E
----xxx-----SSS
---xx<>--------
--xx-[]-------X
-xx--[]-------X
xx---[]----E--X
XSXXXXXXXXXXXXX