---------------
---------------
---------------
-----xxxx------
----xx---x-----
---xx-----x----
--xx-------x-E-
-xxXX-------x--
xxXXX--------x-
xXXXX---------x
XXXXX----------
XXXXX----------
XXXXX----------
XXXX-----------