---------------
---------------
SSSSSSSSSSSSSS-
---------------
---------------
---------------
---------------
---------------
-----------xxxx
xx--------xxXXX
S-x------xxEXXX
S--x----xxXXXXX
S---xxxxxXXXXXX
X--XXXXXXXXXXX-