xxxxxx---------
x-----x--------
]------x-------
]-------x--xxx-
]--------xxx--x
>--------XXX---
]--------XXX---
]--------XXX---
]--------XXX---
[--------XXX---
S--------XXX---
S--------XXX---
S--------XXX---
X--------XXXXXX