---------------
---------------
SSSSSSSSSSSSSSS
SSSSSSSSSSSSSSS
SSSSSSSSSSSSSSS
SSSSSSSSSSSSSSS
---------------
--------------x
xxxxxxxxxxxxxxx
SSSSSSSSSSSSSSS
SSSSSSSSSSSSSSS
SSSSSSSSSSSSSSS
SSSSSSSSSSSSSSS
XXXXXXXXXXXXXXX