---------------
---------------
---------------
------xxx------
----xxx--x-----
---xxXX---x----
--xxXXX----x-E-
-xxXXXX-----x--
xxXXXXX------x-
xXXXXXX-------x
XXXXXXX--------
XXXXXXX--------
XXXXXXX--------
XXXXXXX--------