---------------
--------------x
-------------xx
-----xxxxx--xx-
----xx----xxx--
---xxX-----x---
--xxXX----XX---
-xxXXXXX-------
xxXXXX---------
xXXXXX---------
XXXXXX---------
XXXXXX-E-------
XXXXXX<>-------
XXXXXX[]-------