---------------
---------------
---------------
---------------
---------------
--------E-----E
-----E-------<>
-------------[]
--xxxx-------[]
-xx---x------XX
xx-----x-------
x-------x-----x
B--------xxxxxx
X--------XXXXXX