---------------
---------------
---------------
---------------
---------------
---------------
---------------
x--------------
-x-------------
--x---------Q--
---x-----------
----x----------
---X-xxxxxxxxxx
XXXXXXXXXXXXXXX