---------------
---------------
---------------
---------------
---------------
E-E-E----------
><><>----------
][][]----------
QQQQQ----------
--------------Q
---------xxxx--
--------xx<>-x-
xxxxxxxxx-[]--x
XXXXXXXXXXXXX-X