---------------
---------------
---------------
---------------
----xxxxxxxxxx-
---xx--QQQ?QQ-x
--xx-----------
-xx------EX----
xx-----SSSSSS--
<>-------------
[]-------X-----
[]-------X-----
b]----E--X-----
XXXXXXXXXXXXXXX