---------------
---------------
---------SSSSSS
-----xx--SSSS--
----xx-x-SSSS--
---xx---xSSSS--
--xx-----x-----
-xx-------x----
xx--------oxxx-
<>-------S?SS-x
[]-------SS----
[]-------SS----
[]---------E-EE
XXXXXXXXXXX-XXX