---------------
---------------
SSSSSSSSSSSSSSS
SSSSSSSSSS-----
SSSSSSSSSS-----
SSSSSSSSSS--QQ-
---------------
---------xxx-xx
xxxxxxxxxx--xx-
SSSSSSSSSS--QQ-
SSSSSSSSSS-----
SSSSSSSSSS-----
SSSSSSSSSS-----
XXXXXXXXXXXXXXX