---------------
xxxxxxxxxxxxxxx
SSSSSSSSSSSSSSS
---------------
---------------
---------------
---------------
---------------
-----------E---
-------E--<>---
E-----<>--[]---
>-----[]--[]---
]---E-[]--[]---
XXXXXXXXXXXX--X