---------------
---------------
---------------
---------------
---------------
---------------
---------------
---------------
---------------
---------------
--------------x
x------------xx
-xxxxxxxxxxxxx-
XXXXXXXXXXXXXXX