---------------
---------------
---------------
---------------
-xxxxx---------
xxXXX-x--------
xXXXX--x-------
XXXXX---x------
XXXXX----x-----
XXXXX-----x----
XXXXX------x---
XXXXX-------xxx
XXXXX-------XX-
XXXXXXXXXXXXXXX