------XXXXXXXXY
---------------
---------------
---------------
xxxxxx--xxx----
x---QQQxx--x---
x------Q?---x--
------E------x-
----SSS-------x
-------SS------
------X------E-
------X------X-
---E--X------X-
XXXXXXX------X-