---------------
---------------
SSSSSSSSSSSSSSS
SSSSSSSSSSSSSSS
SSSSSSSSSSSSSSS
SSSSSSSSSSSSSSS
---------------
-xxx-----------
xx?-xxxxxxxxxxx
SS??SSSSSSSSSSS
S---SSSSSSSSSSS
S---SSSSSSSSSSS
-oooSSSSSSSSSSS
XXXXXXXXXXXXXXX