---------------
---------------
---------------
---------------
---------------
-----E-E-------
----<><>-------
----[][]-------
----QQQQ-------
---------------
-------------xx
xxxx---xxx--xx<
----xxxx--xxx-[
X---XXXX--XXXXX