---------------
---------------
---------------
---------------
---------------
x--------------
-x-------------
--x-----------x
-E-x---------xx
<>--x--------x-
[]---x------xx-
[]----x----xx--
[]-----xxxxx---
XXXXXXXXXXXXXXX