---------------
xxxxxxxxxxxxxxx
SSSSSSSSSSSSSSS
---------------
---------------
---------------
---------------
---------------
--------E------
-------<>------
-------[]------
?------[]------
-----E-[]------
X----XXXX--XXXX