---------------
---------------
---------------
---------------
---------------
---------------
--------------x
-------------xx
x----------xxx-
-x---------x<>-
--x-------xx[]-
---x-----xx-[]-
----xxxxxx--[]-
XXXXXXXXXXXXXXX