---------------
---------------
SSSSSSSSSSSSSSS
SSSSSSSSSSSSSSS
SSSSSSSSSSSSSSS
SSSSSSSSSSSSSSS
---------------
xxx------------
x--xxxxxxxxxxxx
???SSSSSSSSSSSS
---SSSSSSSSSSSS
---SSSSSSSSSSSS
oooSSSSSSSSSSSS
XXXXXXXXXXXXXXX