--------------x
xxxxxxxxxxxxxxx
SSSSSSSSSSSSSSS
---------------
---------------
---------------
---------------
---------------
----E----------
---<>----------
---[]---------X
E--[]--------XX
---[]-------XXX
XXXXX---XXXXXXX