xxxx-----------
x---x----------
-----x---------
------x--------
-------x-------
--------x------
---------x-----
----------x----
-----------x---
------------x--
-------------x-
--------------x
-------------X-
XXXXXXXXXXXXXXX