---------------
---------------
---------------
---------------
------xxxxx----
-----xxXXX-x---
----xx-XXX--x--
---xx--XXX---x-
--xxXX-XXX----x
-xxXXX-XXX-----
xxXXXX-XXX-----
xXXXXX-XXX-----
XXXXXX-XXX-----
XXXXX--XXXXXXXX