---------------
---------------
---------------
---------------
---------------
---------------
---------------
-xxxxx----xxxxx
xx----x-xxx----
<>-----xx<>----
[]----E<>[]----
[]---<>[][]----
[]---[][][]----
XXXXXXXXXXXXXXX