---------------
x--------------
-x------SSSSSSS
--x------------
---x-----------
----x----------
-----x---------
------x--------
-------x-------
--------xxxxx--
-E------SSSS-x-
->------SSSS--x
<]-------------
XXXXXXXXXXXX--X