---------------
---------------
---------------
--------xxxxx--
-------xx----xx
------xxX-----x
-----xxXX----XX
----xxXXXXX----
---xxXXXX------
--xxXXXXX------
xxxXXXXXX------
-xXXXXXXX-E----
xXXXXXXXX<>----
XXXXXXXXX[]----