------------xxx
-----------xx--
----------xx---
---------xx----
--------xx-----
--------xX-----
-------xx------
------xx-------
-----xx--------
----xx---------
---xx----------
ooxx-----------
xxx------------
XXXXXXXXXXXXXXX