---------------
---------------
-----------XXXX
------------[]-
------------[]-
------------<>-
---------------
---------------
---------------
--XXXXX----xxxx
----------xx---
---xxx---xx---<
xxxx--xxxx----[
XXXX--XXXX----[