---------------
---------------
---------------
-------xxxxx--x
------xx----xxx
-----xxX-----x-
----xxXX----XX-
---xxXXXXX-----
--xxXXXX-------
-xxXXXXX-------
xxXXXXXX-------
EXXXXXXX-E-----
XXXXXXXX<>-----
XXXXXXXX[]-----