---------------
---------------
SSSSSSSSSSSS---
SSS------------
SSS-----------X
SSS--QQ------xx
------------xx-
xxxxx-xxx--xx--
-----xx--xxx---
-----QQ--QQQ---
---------------
->-------------
-]-------------
XXXXXXXXXXXX---