---------------
---------------
---------------
---------------
----xxxxxxxxxxx
---xx--QQQ?QQQQ
--xx-----------
-xx------E-----
xx-----SSSSSSES
<>----------<>-
[]-------X--[]-
[]-------X--[]-
[]----E--X---]-
XXXXXXXXXXXXXXX