---------------
xxxxxxxxxxxxxxx
SSSSSSSSSSSSSSS
SS-------------
SS-------------
SS----E--------
-----<>--------
-----[]--------
E----[]--------
>---?SSS--E----
]--------<>----
]--------[]---<
]--------[]---[
XXXX----XXX---X