---------------
---------------
---------------
---------------
---xxx---------
--xx--x-----E-S
-xxX---x-E-----
xxXX----x------
xXXX-----x-----
XXXX------x----
XXXX-------x---
XXXX--------x--
XXXX---------xx
XXX----------XX