---------------
---------------
---------------
---------------
---------------
-E-E-E---------
<><><>---------
[][][]---------
QQQQQQ---------
---------------
---------------
-----xxxxxx----
xxxxxx-----xxxx
XXXXXX----XXXXX