---------------
---------------
---------------
---------------
---------------
---------QQQ?QQ
---------------
x--------------
-x-----------xx
--x---------xx-
---x-------xx--
X---x-----xx---
-----xxxxxx----
XXXXXXXXXXXX---