---------------
---------------
---------------
---------------
---------------
---------------
---------------
---------------
---------------
x--------------
-x-------------
--x------------
x-Exxxxxxxxxxxx
XXXXXXXXXXXXXXX