---------------
---------------
X----[]SSSSSSSS
]----[]SSSSSSSS
]----[]SSSSSSSS
]----[]SSSSSSSS
>----[]SSSSSSSS
]----[]SSSSSSSS
X-----]SSSSSSSS
xxxxx-]SSSSSSSS
SSSSSSSSSSSSSSS
SSSSSSSSSSSSSSS
SSSSSSSSSSSSSSS
XXXXXXXXXXXXXXX