---------------
---xx----------
--xx-x---------
-xx---x--------
xx-----x-------
x-------x------
---------x-----
----------x----
E----------x---
>-----------x--
]------------x-
]-------------x
]------------X-
XXXXXXXXXXXXXXX