---------------
---------------
--XXXX---------
--[]-----------
--[]-----------
--[]-----------
--[]-----------
--[]-----------
--[]--xxx------
--XX-xx--x-----
----xx----x----
---xx------x---
xxxx--------xxx
XXXXE--XXXXXXXX