---------------
---------------
---------------
---------------
---------------
-------E-E-E---
------<><><>---
------[][][]---
--Q?--QQQQQQ---
---------------
---------------
---xxx---------
xxxx--xxxxxxxxx
XXXX--XXXXXXXXX