---------------
---------------
--------SSSSSSS
----------[]---
----------[]---
----------[]---
----------<>---
x--------------
-x-------------
--x------------
---x-----------
----x----xxx---
-----xxxxx--xxx
XXXXXXXXXX--XXX