---------------
---------------
---------------
---------------
---------------
-----X--XX-----
-----X--XX-----
----xxx-XX-----
---xxXx-XX-----
--xxXX--XX-----
-xxXXX-xXX-----
xxXXXX--x------
xXXXXX---xxxxxx
XXXXXXXXXXXXXXX